africanamericanstudies	Institute for Research in African American Studies	5	0	7	0	12
americanstudies	American Studies	19	0	5	0	24
anthropology	Anthropology	23	0	10	0	33
appliedmathematics	Mathematics	1	0	0	0	1
archaeology	Archaeology	0	0	1	0	1
architecture	Architecture (Barnard)	8	0	0	0	8
architecture	Architecture, Planning And Preservation	1	0	0	0	1
arthistory	Art History & Archaeology	23	0	25	0	48
arthistoryandvisualarts	NA	0	2	0	0	2
asianamericanstudies	Asian American Studies	1	0	0	0	1
astronomy	Astronomy	4	0	0	0	4
astrophysics	Astronomy-Physics **	0	1	0	0	1
biochemistry	Biological Sciences-Chemistry **	0	14	0	0	14
biology	Biological Sciences	40	0	4	0	44
chemicalphysics	Chemistry-Physics **	0	1	0	0	1
chemistry	Chemistry	4	0	1	0	5
classics	Classics	8	0	1	0	9
comparativeethnicstudies	Center for the Study of Ethnicity and Race	1	0	0	0	1
comparativeliteratureandsociety	Center for Comparative Literature and Society	16	0	0	0	16
computerscience	Computer Science	16	0	15	0	31
dramaandtheatrearts	Drama And Theatre Arts	5	0	0	0	5
earthscience	Earth and Environmental Sciences	1	0	0	0	1
eastasianstudies	East Asian Languages & Cultures	25	0	1	0	26
economics	Computer Science	0	0	1	0	1
economics	Economics	93	0	27	0	120
economicsmathematics	Economics-Mathematics **	0	14	0	0	14
economicsoperationsresearch	Economics-Industrial Engineering & OperationsResearch **	0	4	0	0	4
economicsphilosophy	Economics-Philosophy **	0	18	0	0	18
economicspoliticalscience	Economics-Political Science **	0	37	0	0	37
economicsstatistics	Economics-Statistics **	0	1	0	0	1
english	English & Comparative Literature	106	0	26	0	132
environmentalbiology	Ecology, Evolution, and Environmental Biology	15	0	0	0	15
environmentalchemistry	Chemistry	2	0	0	0	2
environmentalscience	Earth and Environmental Sciences	4	0	2	0	6
filmstudies	Film (School Of The Arts)	26	0	0	0	26
french	French & Romance Philology	12	0	5	0	17
frenchandfrancophonestudies	French & Romance Philology	1	0	0	0	1
german	Germanic Languages	1	0	3	0	4
germanlanguageandliterature	Germanic Languages	1	0	0	0	1
hispanicstudies	Spanish & Portuguese	1	0	3	0	4
history	History	120	0	33	0	153
historyandtheoryofarchitecture	Art History & Archaeology	2	0	0	0	2
historysociology	Sociology-History **	0	3	0	0	3
italian	Italian	0	0	1	0	1
italianculturalstudies	Italian	0	0	1	0	1
latinamericanstudies	Spanish & Portuguese	7	0	1	0	8
latinostudies	Latino Studies	0	0	2	0	2
mathematics	Mathematics	15	0	22	0	37
mathematicsandcomputerscience	Columbia College	1	0	0	0	1
mathematicsstatistics	Mathematics-Statistics **	0	5	0	0	5
middleeastandasianlanguagesandcultures	Middle East and Asian Languages and Cultures	15	0	5	0	20
music	Music	17	0	3	0	20
neuroscienceandbehavior	Biological Sciences-Psychology **	0	33	0	0	33
neuroscienceandbehavior	Neurobiology And Behavior-Psychology **	0	1	0	0	1
philosophy	Philosophy	30	0	16	0	46
physics	Physics	6	0	2	0	8
politicalscience	Political Science	130	0	15	0	145
politicalsciencestatistics	Political Science-Statistics **	0	2	0	0	2
psychology	Psychology	44	0	22	0	66
regionalstudies	Associated Institutes	1	0	0	0	1
religion	Religion	6	0	4	0	10
russian	Slavic Languages	0	0	2	0	2
russianregionalstudies	Slavic Languages	1	0	0	0	1
slaviclanguageandculture	Slavic Languages	0	0	1	0	1
sociology	Sociology	16	0	3	0	19
spanish	Spanish & Portuguese	0	0	2	0	2
spanishlanguageandliterature	Spanish & Portuguese	3	0	8	0	11
urbanstudies	Urban Studies	14	0	0	0	14
visualarts	Visual Arts (School of The Arts)	16	0	6	0	22
women'sandgenderstudies	Women's and Gender Studies	6	0	2	0	8
Grand Totals	Grand Totals	913	136	288	0	1337
NA	NA	NA	NA	NA	Total Number of Degrees	1065
